Joel	Williamson
Johnathan	Moran
Carol	Martinez
Candice	Morton
Christine	Farmer
Alice	Barber
Clifford	Flowers
Jasmine	Barrett
Lamar	Davidson
Betty	Martin
Roxanne	Griffith
Betsy	James
Jill	Bell
Stella	Stokes
Lucia	Burke
Darryl	Ortiz
Marian	Cooper
Erik	Chandler
Madeline	Romero
Kimberly	Carr
Dominick	Russell
Caroline	Stephens
Jamie	Schultz
Leticia	Daniels
Jonathon	Adkins
Nicole	Jacobs
Gladys	Sims
Jean	Greer
Joe	Jackson
Christie	Wright
Ollie	Page
Howard	Thornton
Rosa	Simpson
Vicki	Higgins
Kellie	Fletcher
Roberto	Erickson
Perry	Hardy
Sheldon	Byrd
Salvador	Fowler
Tanya	Miles
Garrett	Bryan
Marion	Padilla
Ernestine	Boyd
Ebony	Saunders
Margaret	Gregory
Harriet	Elliott
Terry	Frazier
Genevieve	Sharp
Ian	Horton
Lowell	Mccoy
Eileen	Kim
Melba	Brady
Santiago	Ruiz
Dora	Park
Curtis	Gibson
Rhonda	Bowen
Bernard	Ray
Stacey	Evans
Lionel	Maxwell
Kristin	Johnston
Jason	Wilson
Ramon	Price
Karla	Weaver
Brett	Black
Neil	Ryan
Arthur	Cox
Cornelius	Murphy
Ethel	Glover
Kevin	Ford
Diana	Maldonado
Mona	Kennedy
Santos	Norman
Mack	Rowe
Lydia	Malone
Muriel	Mason
Benjamin Grant
Olive	Warren
Tara	Porter
Angie	Fuller
Dale	Gordon
Bryan	French
Kirk	Webb
Dallas	Rose
Travis	Long
Penny	Brewer
Christian	Ramos
Alfonso	Day
Lee	Barton
Robyn	Henderson
Leon	Casey
Tomas	Powell
Nancy	Griffin
Anthony	Dunn
Jeremy	Harrison
Kathryn	Lopez
Ryan	Berry
Valerie	Massey
Whitney	Walsh
Andrew	Lewis
Theodore	Turner